

             1
            111
           11011
         111000111
     11111000000011111
   111000000000000000111
  11000000000000000000011
   111000000000000000111
     11111000000011111
         111000111
           11011
            111
             1

             
          111111111111      11111111111
    1111110000000100001111111000000000111
  110000010000000100000000100000000000011
  11000000000000000000000100000000010000011
  1100010000000011110011111111100001111111
11111000000111111  1000001    110011
100011001001     111000011  1110001
110000111001    1100000111111000011
 11100000001    100000000000000011
   111100011    11100000000000011
      11111       11111000001111
                      1111111



         11111111111111     11111111111
    111111000000010000111111100000000011
   110000100000001000000001000000000000111
  110000000000000000000001000000000100000111111111
  100010000000011110011111111100001110000111000011
11111000000111111 11000001   111001111100000000001
100011001001     111000011  1110001 11000000000111
110000111001    1100000111111000011 100000000011 
 11100000001    100000000000000011  10000011111
   111100011    11100000000000011   1000001
      110011      11111000001111 11110000011
      1000011         1100011    10000000001
      11000011111111111100011111110000000011
       110000000000000000000000000000000011
        1110000000000000000N00000000000111
          111111111111111111111111111111