NO ./example.cub
SO   ./example.cub
EA ./example.cub
WE ./example.cub

F 220,100,0
C 225,30 ,0


        111111111111111111111111111111111
        1000000001      10110000000000001
        1011000001      11110000000000001
        100100000111111100000000000000011
11111111101100000111000000000000111111111
100000000011000001110111111111111
11110111111111011100000010001
11110111111111011101010010001
11000000110101011100000010001
10000000000000001100000010001
10000000000000001101010010N01
1100000111010101111101111000111
11110111 1110101 101111010001
11111111 1111111 111111111111
