NO ./textures/BRICK_3B.PNG
SO ./textures/BRICK_2B.PNG
EA ./textures/BRICK_1A.PNG
WE ./textures/BRICK_4A.PNG

F 220,         100,0
C    225,      30,  0

             1
            111
           11011
         111000111
     11111000000011111
   111000000000000000111
  11000000000000000000011
   111000000000000000111
     11111000000011111
         1110N0111
           11011
            111
             1
